9
9
111111111
111111111
111111111
111111111
111111111
111111111
111111111
111111111
111111111

100000001
010000010
001000100
000101000
000010000
000101000
001000100
010000010
100000001

100000001
010000010
001000100
000101000
000010000
000101000
001000100
010000010
100000001