8
8
00000000
00000000
00000000
00000000
00000000
01100110
01100110
00000000

00000000
00000000
00000000
00000000
01100110
11111111
11111111
01100110

00000000
00000000
00000000
00011000
01111110
11111111
11111111
01100110

00000000
00000000
00000000
00011000
01111110
11111111
11111111
01100110

00000000
00000000
00000000
00011000
00011000
01100110
01100110
00000000

00000000
00000000
00000000
00011000
00011000
00000000
00000000
00000000

00000000
00000000
00000000
00011000
00011000
00000000
00000000
00000000

00000000
00000000
00000000
00011000
00011000
00000000
00000000
00000000

00000000
00000000
00000000
00011000
00011000
00000000
00000000
00000000

00000000
00000000
00000000
00011000
00011000
00000000
00000000
00000000

00000000
00000000
00000000
00011000
00011000
00000000
00000000
00000000

00000000
00000000
00000000
00011000
00011000
00000000
00000000
00000000

00000000
00000000
00000000
00011000
00011000
00000000
00000000
00000000

00000000
00000000
00000000
00011000
00011000
00000000
00000000
00000000

00000000
00000000
00000000
00011000
00011000
00000000
00000000
00000000

00000000
00000000
00000000
00011000
00011000
00000000
00000000
00000000

00000000
00000000
00011000
00111100
00111100
00011000
00000000
00000000

00000000
00000000
00011000
00111100
00111100
00011000
00000000
00000000

00000000
00000000
00011000
00111100
00111100
00011000
00000000
00000000

00000000
00000000
00011000
00111100
00111100
00011000
00000000
00000000

00000000
00000000
00000000
00011000
00011000
00000000
00000000
00000000